15 10
1 1 1 1 1 1 1 1 1 1 1 1 1 1 1
1 o 1 0 0 0 1 0 1 0 1 0 1 0 1 
1 0 1 1 1 0 1 0 0 0 0 0 0 0 1
1 0 0 0 0 0 1 0 1 1 0 1 1 0 1
1 1 1 1 1 0 1 0 1 0 0 0 1 0 1
1 0 1 0 1 0 1 1 1 0 1 0 1 0 1
1 0 0 0 0 0 0 0 0 0 1 0 1 0 1
1 0 1 1 1 1 1 0 1 1 1 0 1 0 1
1 0 0 0 0 0 1 0 1 0 0 0 1 x 1
1 1 1 1 1 1 1 1 1 1 1 1 1 1 1